17
17
11111111111111111
10001000000000001
10001000000000001
10001000000000001
30001000100011111
10001000100010001
10001000100010001
10001000100010001
10001111100010001
10000000000010001
10000000000010001
10000000000010001
10001111100010004
10001000000000001
10001000000000001
10001000000000001
11111111111111111