11
10
1111111111
1001000001
1001000001
1001001001
3001111001
1000000004
1000000001
1001111001
1001000001
1001000001
1111111111